30
9
0 0 0 0 0 0 0 0 0 0 0 0 0 0 0 0 0 0 0 0 0 0 0 0 0 0 0 0 0 4 
0 0 0 0 0 0 0 0 0 0 0 0 0 0 0 0 0 0 0 0 0 0 0 13 14 14 14 14 0 4 
0 0 0 0 0 0 0 0 0 0 0 0 0 0 0 0 0 0 0 0 0 0 0 0 0 0 0 0 0 4 
3 0 0 0 0 0 0 0 0 0 0 0 0 0 0 0 0 0 13 14 14 15 0 0 0 0 0 0 0 4 
6 0 0 0 0 0 0 0 0 0 0 0 0 0 0 0 0 0 0 0 0 0 0 0 0 0 0 0 0 4 
6 0 0 0 0 0 0 0 0 0 0 0 0 0 0 0 0 0 0 0 0 0 0 1 2 2 2 2 7 8 
6 0 0 0 0 0 0 0 0 0 0 0 0 0 0 1 2 3 0 0 0 0 0 4 5 5 5 5 5 5 
10 11 2 2 2 2 2 3 17 17 17 17 1 2 7 8 5 10 11 2 2 2 7 8 5 5 5 5 5 5 
5 5 5 5 5 5 5 6 18 18 18 18 4 5 5 5 5 5 5 5 5 5 5 5 5 5 5 5 5 5 
5
1001 248 255 40 10
1003 747 65 40 40
1002 652 192 40 40
1001 937 -3 40 40
1003 56 238 40 40
1
2001 779 230 40 40
